25 25
100 100
4 10 10 10 10 10 10 10 10 10 10 10 10 10 10 10 10 10 10 10 10 10 10 10 5
8 16  16 16  16  16  16  16  16  16  16  16  16  16  16  16  16  16  16  16  16  16  16  16  9
8 16  16  16  16  3  19  19  19  19  19  19  19  16  16  16  16  16  16  16  16  16  16  16  9
8 16  16  16  16  16  19  16  16  16  16  16  19  16  16  16  16  16  16  16  16  16  16  16  9
8 16  16  19  16  16  19  16  16  12 12 16  19  16  16  16  16  16  16  16  16  16  16  16  9
8 16  16  19  16  16  19  16  16  12 12 16  19  16  3  16  16  16  16  16  16  16  16  16  9
8 16  16  19  16  16  19  16  16  16  16  16  19  19  19  19  19  19 19  19  16  16  16  16  9
8 16  16  19  16  16  19  16  16  16  16  16  16  16  16  16  16  16  16  19  16  16  16  16  9
8 16  16  19  16  16  19  16  19  19  19  19  19  19  19  19  19  19  16  19  16  16  16  16  9
8 16  16  19  16  16  19  3  19  16  16  16  16  16  16  16  16  19  16  19  16  16  16  16  9
8 16  16  19  16  16  19  16  19  16  19  19  19  19  19  19  16  19  16  19  16  16  16  16  9
8 16  16  19  16  16  19  16  19  16  19  3  16  16  16  19  16  19  16  19  16  16  16  16  9
8 16  16  19  16  16  19  16  19  16  19  16  16  16  16  19  16  19  16  19  16  16  16  16  9
8 16  16  19  16  16  19  16  19  16  16  16  16  16  16  19  16  19  16  19  16  16  16  16  9
8 16  16  19  16  16  19  16  19  19  19  19  19  19  19  16  16  19  16  19  16  16  16  16  9
8 16  16  19  16  16  19  16  16  16  16  16  16  16  16  16  16  19  16  19  16  16  16  16  9
8 16  16  19  16  16  19  19  19  19  19  19  19  19  19  19  16  16  16  19  16  16  16  16  9
8 16  16  19  16  16  16  16  16  16  16  16  16  16  16  16  16  16  16  19  16  16  16  16  9
8 16  16  19  19  19  19  19  19  19  19  19  19  19  19  19  19  19  19  19 16  16  16  16  9
8 16  16  16  16  16  16  16  16  16  16  16  16  16  16  16  16  16  16  16  16  16  16  16  9
8 16  16  16  16  16  16  16  16  12 16  16  16  16  16  16  16  16  16  16  16  16  16  16  9
8 16  16  16  16  16  16  16  16  16  16  16  16  16  16  16  16  16  16  16  16  16  16  16  9
8 16  16  16  16  16  16  16  16  16  16  16  16  16  16  16  16  16  16  16  16  16  16  16  9
8 16  16  16  16  16  16  16  16  16  16  16  16  16  16  16  16  16  16  16  16  16  16  16  9
7 11 11 11 11 11 11 11 11 11 11 11 11 11 11 11 11 11 11 11 11 11 11 11 6