25 25
5 5
12 12 12 12 12 12 12 12 12 12 12 12 12 12 12 12 12 12 12 12 12 12 12 12 12
12 12  12  12  12  12  12  12  12  12  12  12  12  12  12  12  12  12  12  12  12  12  12  12  12
12 12  12  12  12  12  12  12  12  12  12  12  12  12  12  12  12  12  12  12  12  12  12  12  12
12 12 12 12 12 12 12 12 12 12 12 12 12 12  12  12  12  12  12  12  12  12  12  12  12  1  1  1  15  14
14 14  20  17  18  17  20  14  14  14  14  14  16  14  14  14  14  14  14  14  1  1  1  15  14
14 14  20  17  18  17  20  14  14  14  14  14  16  14  14  14  14  14  14  14  1  1  1  15  14
14 14  20  17  18  17  20  14  14  14  14  14  16  16  16  16  16  16  16  16  1  1  1  15  14
14 14  20  17  18  17  20  14  14  14  14  14  14  14  14  14  14  14  14  16  1  1  1  15  14
14 14  20  17  18  17  20  14  16  16  16  16  16  16  16  16  16  16  14  16  1  1  1  15  14
14 14  20  17  18  17  20  14  16  14  14  14  14  14  14  14  14  16  14  16  1  1  1  15  14
14 14  20  17  18  17  20  14  16  14  16  16  16  16  16  16  14  16  14  16  1  1  1  15  14
14 14  20  17  18  17  20  14  16  14  16  14  14  14  14  16  14  16  14  16  1  1  1  15  14
14 14  20  17  18  17  20  14  16  14  16  14  14  14  14  16  14  16  14  16  1  1  1  15  14
14 14  20  17  18  17  20  14  16  14  14  14  14  14  14  16  14  16  14  16  1  1  1  15  14
14 14  20  17  18  17  20  14  16  16  16  16  16  16  16  14  14  16  14  16  1  1  1  15  14
14 14  20  17  18  17  20  14  14  14  14  14  14  14  14  14  14  16  14  16  1  1  1  15  14
14 14  20  17  18  17  20  14  16  16  16  16  16  16  16  16  14  14  14  16  1  1  1  15  14
14 14  20  17  18  17  20  14  14  14  14  14  14  14  14  14  14  14  14  16  1  1  1  15  14
14 14  20  17  18  17  20  14  16  16  16  16  16  16  16  16  16  16  16  16  1  1  1  15  14
14 14  20  17  18  17  20  14  14  14  14  14  14  14  14  14  14  14  14  14  1  1  1  15  14
14 14  20  17  18  17  20  14  14  14  14  14  14  14  14  14  14  14  14  14  1  1  1  15  14
14 14  20  17  18  17  20  14  14  14  14  14  14  14  14  14  14  14  14  14  1  1  1  15  14
14 14  20  17  18  17  20  14  14  14  14  14  14  14  14  14  14  14  14  14  1  1  1  15  14
14 14  20  17  18  17  20  14  14  14  14  14  14  14  14  14  14  14  14  14  1  1  1  15  14
14 14  20  17  18  17  20  14  14  14  14  14  14  14  14  14  14  14  14  14  1  1  1  15  14