25 25
5 5
12 12 12 12 12 12 12 12 12 12 12 12 12 12 12 12 12 12 12 12 12 12 12 12 12
12 12  12  12  12  12  12  12  12  12  12  12  12  12  12  12  12  12  12  12  12  12  12  12  12 
12 12  12  12  12  12  12  12  12  12  12  12  12  12  12  12  12  12  12  12  12  12  12  12  12 
26 25  21  21  21  21  21  21  21  21  21  21  21  21  21  21  21  21  21  21  21  21  21  21  12 
1  15  14  20  17  18  17  20  14  14  14  14  14  16  14  14  14  14  14  14  14  14  14  14  22   				     
1  15  14  20  17  18  17  20  14  14  14  14  14  16  14  14  14  14  14  14  14  14  14  14  22   				     
1  15  14  20  17  18  17  20  14  14  14  14  14  16  16  16  16  16  16  16  14  14  14  14  22   				    
1  15  14  20  17  18  17  20  14  14  14  14  14  14  14  14  14  14  14  14  14  14  14  14  22   				    
1  15  14  20  17  18  17  20  14  16  16  16  16  16  16  16  16  16  16  14  14  14  14  14  22   				    
1  15  14  20  17  18  17  20  14  16  14  14  14  14  14  14  14  14  16  14  14  14  14  14  22   				     
1  15  14  20  17  18  17  20  14  16  14  16  16  16  16  16  16  14  16  14  14  14  14  14  22   				     
1  15  14  20  17  18  17  20  14  16  14  16  14  14  14  14  16  14  16  14  14  14  14  14  22   				     
1  15  14  20  17  18  17  20  14  16  14  16  14  14  14  14  16  14  16  14  14  14  14  14  22   				     
1  15  14  20  17  18  17  20  14  16  14  14  14  14  14  14  16  14  16  14  14  14  14  14  22   				     
1  15  14  20  17  18  17  20  14  16  16  16  16  16  16  16  14  14  16  14  14  14  14  14  22   				    
1  15  14  20  17  18  17  20  14  14  14  14  14  14  14  14  14  14  16  14  14  14  14  14  22   				    
1  15  14  20  17  18  17  20  14  16  16  16  16  16  16  16  16  14  14  14  14  14  14  14  22  				     
1  15  14  20  17  18  17  20  14  14  14  14  14  14  14  14  14  14  14  14  14  14  14  14  22   				   
1  15  14  20  17  18  17  20  14  16  16  16  16  16  16  16  16  16  16  16  14  14  14  14  22   				     
1  15  14  20  17  18  17  20  14  14  14  14  14  14  14  14  14  14  14  14  14  14  14  14  22   				     
1  15  14  20  17  18  17  20  14  14  14  14  14  14  14  14  14  14  14  14  14  14  14  14  22   				    
1  15  14  20  17  18  17  20  14  14  14  14  14  14  14  14  14  14  14  14  14  14  14  14  22   				    
1  15  14  20  17  18  17  20  14  14  14  14  14  14  14  14  14  14  14  14  14  14  14  14  22 
1  15  14  20  17  18  17  20  14  14  14  14  14  14  14  14  14  14  14  14  14  14  14  14  22   				    
1  15  14  20  17  18  17  20  14  24  23  23  23  23  23  23  23  23  23  23  23  23  23  23  12